WE ./textures/van.png
NO ./textures/bluestone.png
SO ./textures/soldate.png
EA ./textures/sprite_2.png

F 0,180,0
C 0,0,180


11111111111
1001010001
1010001001
1100N00101
1000000011
100000001
10010001
100010001
1000010001
10001010001
1111 111111111
