WE ./textures/van.png
NO ./textures/bluestone.png
SO ./textures/soldate.png
EA ./textures/sprite_2.png

F 0,180,0
C 0,0,180


11111111111
1001010001
1010001001
1100N00101
1000000011
10000000001
100100000001
1000100000101
1000010001001
1000001010001
11111111111111