WE ./textures/van.png
NO ./textures/akatski.png
SO ./textures/soldate.png
EA ./textures/bleach.png

F 0,180,0
C 0,180,0
            111
            101
            101
            101
            101
            101
            101
            101
            101
            101
            101
            101
            101
            101
            101
            101
            101
            101
            101
            101
            101
            101
1111111111111011111111111111111111111111
100101111111101111111111111111111110001
101000000000000000000000000000000001001
1100W0000000000000000000000000000000101
100000000000000000000000000000000000011
100000000000000000000000000000000000011
100100000000000000000000000000000000111
100010000000000000000000000000000000011
1000011111111111111111110111111111100011
1000100000000000000000000000000000010001
1111 111110011111111111111111111111111111111
         1001
         1001
         1001
         1001
         1001
         1001
         1001
         1001
         1001
         1001
         1001
         1001
         1001
         1001
         1001
         1001
         1001
         1001
         1001
         1001
         1001
         1001
         1001
         1001
         1001
         1001
         1001
         1001
         1001
         1001
         1111
