WE ./textures/van.png
NO ./textures/akatski.png
SO ./textures/soldate.png
EA ./textures/bleach.png

C 0,0,255
F 0,0,0
            1111111111111111111111
            1000000000000000000001
            1011111111111111111101
            101                101
            101                101
            101                101
            101                101
            1011111111111111111101
            1000000000000000000001
            1011111111111111111111
            101
            101
            101
            101
            101
            101
            101
            101
            101
            101
            101
            101
1111111111111011111111111111111111111111
1001011111111011111111111111111111100001
1010000000000000000000000000000000010011
1100W00000000000000011111000000000001011
10000000000000000001    10000000000000001
1000000000000000000111111000000000000111
1001000000000000000000000000000000000001
1000100000000000000000000000000000000101
1000011111111111111111110111111111100011
1000100000000000000000000000000000010001
1111 11111001111111111111111111111111111
         1001
         1001
         1001
         1001
         1001
         1001
         1001
         1001
         1001
         1001
         1001
         1001
         1001
         1001
         1001
         1001
         1001
         1001
         1001
         1001
         1001
         1001
         1001
         1001
         1001
         1001
         1001
         1001
         1001
         1001
         1111
