WE /Users/jbelkerf/Desktop/cub3D42/textures/eagle.png
NO /Users/jbelkerf/Desktop/cub3D42/textures/purplestone.png
SO /Users/jbelkerf/Desktop/cub3D42/textures/sprite_3.png
EA /Users/jbelkerf/Desktop/cub3D42/textures/sprite_2.png

F 128,0,128
C 75,0,130


11111111111111111111
1N000000000000000001
11111111110011111111
111100001100101000001
10010000000001001101
11110000010000110001
10000000000000111101
11110100000101101111
1111011111110100001
11000000010101100001
10000000000000100001
10000000010000100001
11000001010101110111
11110111110101100001
11111111111111111111