NO ./path_to_the_north_texture
WE  ./path_to_the_west_texture
SO ./path_to_the_south_texture
EA ./path_to_the_east_texture

F 128,0,128
C 75,0,130


11111111111111111111
1N000000000000000001
11111111110011111111
11110000110000000001
10010000000000001101
11111111110000110001
10000000110000111101
11110111111101101111
1111011111110100001
11000000010101100001
10000000000000100001
10000000010000100001
11000001010101110111
11110111110101100001
11111111111111111111