NO ./path_to_the_north_texture
WE  ./path_to_the_west_texture
SO ./path_to_the_south_texture
EA ./path_to_the_east_texture

F 230,100,0
C 225,30,0


    11111111111111111111111111111
    11111111111111111111111111111
    1111000001110000000000001
    1001000000000000000000001111
111111111011000001110000000000001
100000000011000001110111111111101
11110111111111011100000010001111
11110111111111011101010010001
11000000110101011100000010001
10000000100000001100000010001
10000000000100001101010010001
110000011101010111110111100111
11110111 1110101 1011110100N1
11111111 1111111 111111111111