NO ./path_to_the_north_texture
SO ./path_to_the_south_texture
WE ./path_to_the_west_texture
EA ./path_to_the_east_texture

F 0,180,0
C 0,180, 1


1111111111111111111111111111111111111111111111111
1N00000000000000000000000000000000000000000000001
1000000000000000000000000000000000000000000000001
1000010000000000100000000011111111111110000000001
1000010000000000100000000000000000000000000000001
1000010000000000100000000000000000000000000000001
1000010000010000100000000000000000000000000000001
1000010000010000100000001111111111111111100000001
1000000000010000000000000010000000000000000000001
1000000111110000000000000010000000000000000000001
1000000000000000000000000000000000000000000000001
1111111111111111111111111111111111111111111111111