NO ./path_to_the_north_texture
SO ./path_to_the_south_texture
WE ./path_to_the_west_texture
EA ./path_to_the_east_texture

F 220,100,0
C 225,30,0


11111111111111111111111
10000000000000000000001
10000100000000001000001
10000100000000001000001
10000100N00000001000001
10000100000100001000001
10000100000100001000001
10000000000100000000001
10000001111100000000001
10000000000000000000001
11111111111111111111111