WE ./textures/van.png
NO ./textures/bluestone.png
SO ./textures/soldate.png
EA ./textures/sprite_2.png

F 0,0,0
C 0,0,255


    11111111111111111111111111111111111111
    1N000000000000000000000000000000000001
    111100000000000000100000001001111111111
    111101010101010101010000110010100000001
    10010101010101010101000000000100111111
11110101010101010101000001000011000001
1000000000000000000000000000001111111
11110101010101010101010000010110111111
1111010101010101010101111111010000001
11000000000000000000000001010110000001
10000000000000000000000000000010000001
10000000000000000000000001000010000001
11000000000000000000000101010111011111
11110101010101010101011111010110000001
11110101010101010101011111010110000001
11111111111111111111111111111111111111


11