WE ./textures/van.png
NO ./textures/akatski.png
SO ./textures/soldate.png
EA ./textures/bleach.png
DO ./textures/door.png

C 0,0,255
F 0,0,0


    11111111111111111111111111111111111111
    1N000000000000000000000000000000000001
    1111D111100000000100000001001111111111
    11110DDD0001010101010000110010100000001 
    10010111010101D101010000000001111111111
11110101010101011D0D00110000011111
100000000000000001D1000000000011111111
11110101010101010101010000010110111111
11110101010101010111101111111010000001
11000000000000000000000001010110000001
10000000000000000000000000000010000001
10000000000000000000000001000010000001
11000000000000000000000101010111011111
11110101010101010101011111010110000001
11110101010101010101011111010110000001
11111111111111111111111111111111111111111111111111